####################
#@............#....#
#########....##.##.#
#.!..........#..#..#
#####....#####.##..#
#..#........#..#...#
#...##......#..#...#
#.....#........#...#
#.....##########...#
#..!...............#
#..................#
#..................#
###########.########
#..................#
#..................#
#..................#
#..................#
#................###
#.................*#
####################