####################
#@.................#
#########....#######
#.!..........#.....#
#####....#####.....#
#...........#......#
#...........#......#
#..................#
#..................#
#..................#
#..................#
#..................#
###########.########
#..................#
#..................#
#..................#
#..................#
#..................#
#..................#
####################