#################
#@..............#
#########....####
#............#..#
#####....#####..#
#...........#...#
#...........#...#
#...............#
#...............#
#..............#
#...............#
#...............#
###########.#####
#...............#
#...............#
#...............#
#...............#
#...............#
#...............#
#################