####################
#@............#....#
#########....##.##.#
#.!..........#..#..#
#####....#####.##..#
#..#........#..#...#
#...##......#..#...#
#.....#........#...#
#.....########.#...#
###!...............#
#.......!..........#
#..................#
###########.########
#...!.......##...###
#.##########...#...#
#....!.......#.....#
#...##########.#####
#####............###
#....!............*#
####################