###################
#@......#.#.......#
#.#####......####.#
#....#
#
#
#
#
#
#
#
#
#
#
#
#
#
#
##.#.####
##..###..#
##........#
#.....#..#
###..###..#
#..#....#
##.##.#.##
#......##
#.!...##
###################