###################
#@......#.#.......#
#.#####......####.#
#....#.....##.....#
#....!......#.....#
#.!........#......#
#.......#####.....#
######..#####.....#
#......######.....#
#....!.......######
#....#######......#
#...#########.....#
#..##########.....#
#.###########.....#
#...!.............#
#.....#....#..#...#
#....!...#.!......#
#.........!.......#
##.#.####
##..###..#
##........#
#.....#..#
###..###..#
#..#....#
##.##.#.##
#......##
#.!.....##
###################